555555555555555
535555555552555
555555555555555
555551555551555
555555555555555
525555555552555
555555355555555
535555555555555
555555555555555
555555525555555
555555555555555
515553555555555
555555555555555