555555535555555
515555555555515
555555555555555
555555555555555
555555555251555
555155555555555
555555555555555
555555555555555
555255555352555
555555555555555
555555555555555
535555555555525
555555515555555