555555555555555
121512121212151
555555555555555
121512121212151
555555555555555
121515555512151
555555555555555
121515555512151
555555555555555
121512121212151
555555555555555
121212121212121
555555555555555


