555555555555555
515555551255525
512555521155515
552555515155555
511555555255515
522555555555515
555555555555555
525555121255555
515555212155555
555555555555555
525555555555125
515555555555215
555555555555555

