555555525555555
521155515551125
515555555555515
515555555555515
555212121212555
555255555552555
555255555552555
555255555552555
555212121212555
515555555555515
515555555555515
521155515551125
555555525555555

